    ******   ++               *                   ***         *         **                  **      
    ******                    *      *        *               **   *   **        *         ***     *
       ***         ****       *       *      **        *+           *            ***       **     * 
       ***         ****                              ***+     **        **                          
 **                               +*                         ***        +++*              **    *+  
 **          *         **         **        *      **             *     *                       *+  
     *       ***        *                  * *    +**                   *     **     *          *+  
     ***                                     *    ***   *       *                       *+       *  
     ****                       ***          *    **   **   *   **                      ***         
              +++*                ***                       +             ****     *           *+*  
              ****       *                 *           **   +   **           *     *           *+*  
***                       *                    ***      *   +   *      *                     ***    
***     **            **        *+            *++*      *   +   *                  ***              
        **            ***       **            *++*                                                  
        **      **              **       *     +*                           ***          *      ++* 
               ***      *       **      **               ****                 ***       *           
                *       *              *                     **      *                            **
 **     ***             *                          ***               **            ++             +*
 ****   ***       **                         **     *                                            ***
  +**            **+      *     ***       *****                             ***+          *      ***
  +***           *       *      ***       **                 **    +*       ****          *         
   *+*        ***             ***         *        **      **      +*          *    *     **        
                       *      *                   **               **          *   *              ++
   **         ***      *                   *           *           **                               
   **         *+                ****        *               * *     +                   *      *    
   *          *                 ****                **       *                ***     **       *    
   *                   *                        *             *           *                         
             *       ***        **             *+           +++*         *       ***      *         
            *                           *                    **     *                      *   *    
    ***                  **            *       ***   *               *       *      *               
     +*        ***       +**      *             **  *      * *             ***       *              
     +*          *                      *  * *  **        * + *      +*              *    ***++     
*                             ****++                     * * * *    +*      *                 *     
*                   ****        ****      **                * +              *+      *              
*     **               ***                                                    *     *               
    ******   ++               *                   ***         *         **                  **      
    ******                    *      *        *               **   *   **        *         ***     *
       ***         ****       *       *      **        *+           *            ***       **     * 
       ***         ****                              ***+     **        **                          
 **                               +*                         ***        +++*              **    *+  
 **          *         **         **        *      **             *     *                       *+  
     *       ***        *                  * *    +**                   *     **     *          *+  
     ***                                     *    ***   *       *                       *+       *  
     ****                       ***          *    **   **   *   **                      ***         
              +++*                ***                       +             ****     *           *+*  
              ****       *                 *           **   +   **           *     *           *+*  
***                       *                    ***      *   +   *      *                     ***    
***     **            **        *+            *++*      *   +   *                  ***              
        **            ***       **            *++*                                                  
        **      **              **       *     +*                           ***          *      ++* 
               ***      *       **      **               ****                 ***       *           
                *       *              *                     **      *                            **
 **     ***             *                          ***               **            ++             +*
 ****   ***       **                         **     *                                            ***
  +**            **+      *     ***       *****                             ***+          *      ***
  +***           *       *      ***       **                 **    +*       ****          *         
   *+*        ***             ***         *        **      **      +*          *    *     **        
                       *      *                   **               **          *   *              ++
   **         ***      *                   *           *           **                               
   **         *+                ****        *               * *     +                   *      *    
   *          *                 ****                **       *                ***     **       *    
   *                   *                        *             *           *                         
             *       ***        **             *+           +++*         *       ***      *         
            *                           *                    **     *                      *   *    
    ***                  **            *       ***   *               *       *      *               
     +*        ***       +**      *             **  *      * *             ***       *              
     +*          *                      *  * *  **        * + *      +*              *    ***++     
*                             ****++                     * * * *    +*      *                 *     
*                   ****        ****      **                * +              *+      *              
*     **               ***                                                    *     *               
   **         ***      *                   *           *           **                               
   **         *+                ****        *               * *     +                   *      *    
   *          *                 ****                **       *                ***     **       *    
   *                   *                        *             *           *                         
             *       ***        **             *+           +++*         *       ***      *         
            *                           *                    **     *                      *   *    
    ***                  **            *       ***   *               *       *      *               
     +*        ***       +**      *             **  *      * *             ***       *              
     +*          *                      *  * *  **        * + *      +*              *    ***++     
*                             ****++                     * * * *    +*      *                 *     
*                   ****        ****      **                * +              *+      *              
*     **               ***                                                    *     *               
    ******   ++               *                   ***         *         **                  **      
    ******                    *      *        *               **   *   **        *         ***     *
       ***         ****       *       *      **        *+           *            ***       **     * 
       ***         ****                              ***+     **        **                          
 **                               +*                         ***        +++*              **    *+  
 **          *         **         **        *      **             *     *                       *+  
     *       ***        *                  * *    +**                   *     **     *          *+  
     ***                                     *    ***   *       *                       *+       *  
     ****                       ***          *    **   **   *   **                      ***         
              +++*                ***                       +             ****     *           *+*  
*                       **                         *                                                
**     *        **      **       **      *        *                 *             *     *           
**+     *       ++*              **       * *            ****             *       *     *+          
***              *               **      * *        +    *  *    *            *             ***     
+++         *             +++*             * *      +           *                    ***            
           *        *      **      *      *+  *     *        *           *                          
     *               *             *       *          *   *  + *       ***     *          *    *    
   ******      *+           *      *          *      *     **+*                 **++*      *        
